XXXXXXXXXXXXXXXXXXXXXXXXXX
X21311121XXX212112341XX1aX
X1231XX11X322112X32312234X
X44211XXX411213X212X212X1X
Xe12412XX12XX142122XX3312X
X1232331X4XX1221322X12323X
X23142323XX22411113223141X
X22313X223bXXXc1233223221X
X12323321XXX1332121322142X
X3424313XXX22211212312231X
X123132114XX4323211232321X
X12121231231XXXXXX4121322X
X12123312212112d44XX12231X
X132124421231322213XX1221X
X12343242312122XX23412221X
XXXXXXXXXXXXXXXXXXXXXXXXXX